aleph						ālef
apte						āptλ	
actor						λkøtar
good           			    gud
morning					    mör-neŋg  
hello 						h@lo
how							hāw					
price                       p-rāes
normal						nörømal
craft                       k-rāf-t
somebody	                sambadee
something                   smŧ-heŋg 
longer                      löŋgar
respect						res-pλk-t				    
frankly					    f-r@n-klee 
openly                      opanlee
first						fars-t
outstanding                 åts-t@n-deŋg
age							λj
peace  						pees
mind						māen-d
responsible					res-pönøsebal
running						raneŋg						
angry 						@ŋg-ree
seek						seek				    
evening						evaneŋg
afternoon					āf-tarnuun
development                 dλvlapmλл-t
honesty						önλs-tee
understand					an-dars-t@n-d
matter					    m@t-tar				
against						agλŋs-t
trust						t-ras-t					
election					elλkøs-han
clothes 					k-löđ-s
express						λk-sp-rλs
remember					remλm-bar						
bring						b-reŋg
generations					janarλs-han-s
fear						feyar
trouble                     trabal
enjoy 						λn-jöy
request 					rek-wλs-t
identity					āydλnøtetee
company						kamøpanee
forgive					    fargew
muhammed					muhamađ                 
daughter                    dötar
departmental                depār-tømλn-tal
store						s-toar
shopping                    s-höpeŋg
popular                     pöpular
problem                     p-röbølλm                  
scratching					s-k-r@ceŋg
childhood					cāel-dhud
sufficient					saf-fes-han-t
conversation				könøvarsλs-han
whereas 	                w-hλar@z 
recognition	                rλkagnes-han
of	                     	öf
the 	                    đa 
inherent 	                enhλran-t 
dignity 	                degnete 
and	                     	@n-d
equal 	                    ek-wal 
and 	                    @n-d 
inalienable 	            enλleλnλbal 
rights 	                    raet-s 
all 	                    öl-l 
members 	                mλm-barz 
human 	                    h-yuman 
family 	                    f@melee 
is 	                     	ez 
foundation 	                fån-dλys-han  
freedom 	                f-reedam 
justice 	                jas-tes 
in 	                     	en 
world	                    warl-d

aaron	                  	λyran
ab	                  		λ bee
abhishek	                ab-hes-hλk
adam	                  	ø@dam
aditya	                  	ađeŧ-ya
agarwal	                  	agarwāl
ahmed	                  	ahmađ
ajinkya	                  	ajeŋk-ya
akila	                  	akelā
akshdeep	                ak-s-h-deep
al	                  		ø@l
alex	                  	ø@lλk-s
ali	                  		ālee
ambati	                  	am-batee
amit	                  	ameŧ
anderson	                ø@n-darsan
andre	                  	ān-đrλ
andrew	                  	ø@n-dru
aniket	                  	anekλŧ
aniruddha	                aneruđ-đ-ha
ankit	                  	aŋket
anukul	                  	anukul
anureet	                  	anureeŧ
apoorv	                  	apuur-w
archer	                  	ārcar
aryaman	                  	ar-yaman
ashwin	                  	as-hwen
asif	                  	asef
avesh	                  	āwλs-h
axar	                  	ak-s-har
baby	                  	bλbee
bangalore	                b@ŋgaloar
barinder	                baren-đar
basil	                  	bλzel
behrendorff	                behrλndör-f
ben	                  		bλn
bhui	                  	b-hue
bhuvneshwar	                b-huwanλs-hwar
billings	                bel-leŋg-z
billy	                  	bel-lee
binny	                  	ben-ne
bipul	                  	bepul
birla	                  	bir-lā
bishnoi	                  	bis-hлöy
boult	                  	bol-t
brathwaite	                b-r@ŧ-hwλλt
bravo	                  	b-rāvo
brendon	                  	b-rλndan
bumrah	                  	bumrā
buttler	                  	batlar
cameron	                  	k@maran
carlos	                  	kārlos
chahal	                  	cahāl
chahar	                  	cahā
chaitanya	                cδŧan-ya
challengers	                c@l-leλnjar-z
chameera	               	cameerā
chawla	                  	cāwlā
chennai	                  	cλn-naee
chopra	                  	cop-rā
choudhary	                cåđ-haree
chris	                  	k-h-res
christian	                k-h-rescan
colin	                  	kölen
corey	                  	köre
coulter-nile	            kol-tar-nδl
cummins	                  	kamen-s
curran	                  	kar-ran
cutting	                  	kateŋg
dagar	                  	dāgar
dala	                  	ɖālā
dananjaya	                d-hananjay
daniel	                  	d@n-yal
dar	                  		dār
d'arcy	                  	dārse
daredevils	                dλardλval-s
david	                  	dλyved
de	                  		de
deepak	                  	đeepak
delhi	                  	del-lee
delport	                  	dλlpor-t
deshpande	                đλs-hpān-dλ
dhawal	                  	đ-hawal
dhawan	                  	đ-hawan
dhillon	                  	đ-hel-lan
dhoni	                  	đ-honee
dhruv	                  	đ-h-ruw
dinesh	                  	đenλs-h
du	                  		đu
duminy	                  	dumenee
dushmantha	                đus-hmanŧa
dwarshuis	                đ-warshues
dwayne	                  	d-wλayn
evin	                  	λven
faf	                  		f@f
finch	                  	fen-c
gambhir	                  	gamb-heer
gautam	                  	gåŧam
gayle	                  	gλl
ghosh	                  	g-hos-h
gill	                  	gel-l
glenn	                  	g-lλn
gopal	                  	gopāφ
goswami	                  	gos-wāmee
gowtham	                  	gåŧam
grandhomme	                g-r@n-dhom
gurkeerat	                gurkeeraŧ
hales	                  	hλyl-s
harbhajan	                harb-hajan
hardik	                  	hār-đek
harshal	                  	has-hal
hasan	                  	hasan
heinrich	                hδnrek-h
hooda	                  	huudā
hyderabad	                hδđarābād
imran	                  	emrān
indians	                  	en-deyan-s
ish	                  		es-h
ishan	                  	es-hān
ishank	                  	es-hāŋk
iyer	                  	δyar
jadeja	                  	jadλjā
jadhav	                  	ɉāđ-haw
jagadeesan	                jagađees-han
jaggi	                  	jag-gee
jason	                  	jλysan
jasprit	                  	jasp-reŧ
jatin	                  	jaŧen
javon	                  	javön
jayant	                  	jayan-ŧ
jaydev	                  	jayđλw
jofra	                  	jöf-rā
johnson	                  	jānsan
jordan	                  	jördan
jos	                  		jös
joshi	                  	ɉos-hee
jp	                  		jλ pee
junior	                  	j-yuneyr
kagiso	                  	kageso
kalra	                  	kālrā
kamlesh	                  	kamlλs-h
kane	                  	kλyn
kanishk	                  	kanes-h-k
karn	                  	kār-л
karthik	                  	kārŧek
karun	                  	karuл
kaul	                  	kål
kedar	                  	kλđār
khaleel	                  	k-haleel
khan	                  	k-hān
khejroliya	                k-hλjroleya
kieron	                  	keyaran
kings	                  	keŋg-z
kishan	                  	kes-han
kl	                  		kλ λl
klaasen	                  	k-laasλn
knight	                  	nδt
kock	                  	kök
kohli	                  	kohlee
kolkata	                  	kolkaŧā
krishna	                  	k-rus-hлa
krishnappa	                k-rus-hлap-pā
krunal	                  	k-ruлāl
kshitiz	                  	k-s-heŧej
kuldeep	                  	kulđeep
kulkarni	                kul-kar-лee
kulwant	                  	kulwan-ŧ
kumar	                  	kumār
lad	                  		lād
lamichhane	                lamec-hānλ
laughlin	                laflen
lewis	                  	lues
liam	                  	leyam
lomror	                  	lomror
lumba	                  	lum-bā
lungi	                  	luŋge
lynn	                  	len-n
m.	                  		λm
mahipal	                  	mahepāl
mandeep	                  	manđeep
manish	                  	manes-h
manjot	                  	manjoŧ
manoj	                  	manoj
manzoor	                  	man-suur
marcus	                  	mār-kas
mark	                  	mār-k
markande	                mār-kan-dλ
mavi	                  	māwe
maxwell	                  	m@k-swλl-l
mayank	                  	māyaŋk
mcclenaghan	                maklλnahan
mccullum	                makalam
mehdi	                  	mλhdee
midhun	                  	meŧ-hun
miller	                  	mel-lar
milne	                  	mel-na
mishra	                  	mes-hrā
mitchell	                mec-cλl
moeen	                  	moeen
mohammed	                maham-mađ
mohit	                  	moheŧ
mohsin	                  	mohsen
monu	                  	monu
morris	                  	möres
ms	                  		λmλs 
mujeeb	                  	mujeeb
mumbai	                  	mumbaee
munro	                  	man-ro
murali	                  	muralee
murugan	                  	murugan
mustafizur	                mus-ŧafezur
nabi	                  	nābee
nadeem	                  	nađeem
nagarkoti	                nāgarkotee
nair	                  	nāyr
naman	                  	naman
narayan	                  	nārāyaл
narine	                  	narλn
natarajan	                natarājan
nath	                  	nāŧ-t
nathan	                  	nayŧ-han
navdeep	                  	nawđeep
negi	                  	nλgee
ngidi	                  	ŋgede
nidheesh	                neđ-hees-h
nitish	                  	neŧes-h
ojha	                  	ozā
pakteen	                  	pakŧeen
pandey	                  	pđn-dλ
pandya	                  	pand-yā
pant	                  	pan-ŧ
pardeep	                  	pardeep
parthiv	                  	pārŧ-hew
pat	                  		p@t
patel	                  	patλl
pathan	                  	pat-haл
pavan	                  	pawan
pawan	                  	pawan
piyush	                  	peyus-h
plessis	                  	p-les-see
plunkett	                plaŋkλt-t
pollard	                  	pöl-lar-d
pradeep	                  	p-rađeep
prashant	                p-ras-hān-ŧ
prasidh	                  	p-raseđ=h
prithvi	                  	p-ruŧ-h-we
punjab	                  	panjāb
quinton	                  	k-wentan
rabada	                  	rabādā
rahane	                  	rahāлλ
rahman	                  	rahmān
rahul	                  	rāhul
raina	                  	rδnā
rajasthan	                rajasŧ-hān
rajpoot	                  	rājpuuŧ
rana	                  	rāлā
rashid	                  	ras-heđ
ravichandran	            rawecanđ-ran
ravindra	                raven-đ-ra
rayudu	                  	rāydu
ricky	                  	reke
riders	                  	rāydar-z
rinku	                  	reŋ-ku
rishabh	                  	res-hab-h
robin	                  	rāban
rohit	                  	roheŧ
roy	                  		röy
royal	                  	röyal
royals	                  	röyal-s
russell	                  	rasal
sachin	                  	sacen
saha	                  	sāhā
sahu	                  	sāhu
saini	                  	sδne
sam	                  	 	s@m
samson	                  	s@msan
sandeep	                  	sanđeep
sangwan	                  	saŋgwan
sanju	                  	san-ju
santner	                  	s@n-tnar
sarfaraz	                sarfarāz
saurabh	                  	sårab-h
saxena	                  	sak-sλnā
sayan	                  	sayan
searles	                  	sar-l-z
seth	                  	s-hλt-h
shahbaz	                  	s-hāhbaɉ
shakib	                  	s-hakeeb
shami	                  	s-hāmee
shane	                  	s-hλyn
shankar	                  	s-haŋ-kar
sharad	                  	s-harađ
shardul	                  	s-hār-đul
sharma	                  	s-harmā
shaw	                  	s-hö
shikhar	                  	s-hek-har
shivam	                  	s-hewam
shorey	                  	s-horey
short	                  	s-hör-t
shreevats	                s-hreewaŧ-s
shreyas	                  	s-h-rλyas
shubman	                  	s-hubman
siddarth	                seđ-đārŧ-h
siddhesh	                seđ-đ-hλs-h
singh	                  	seŋg
siraj	                  	serāj
smith	                  	s-meŧ-h
sodhi	                  	sođ-hee
southee	                  	såđee
sran	                  	s-raл
stanlake	                s-tanlλk
starc	                  	s-tār-k
steve	                  	s-teev
stoinis	                  	s-töynes
stokes	                  	s-towk-s
stuart	                  	s-tuar-t
sudhesan	                suđλs-han
sundar	                  	sunđar
sunil	                  	sunel
sunrisers	                sanrδzar-z
super	                  	supar
suresh	                  	surλs-h
suryakumar	                sur-yakumār
syed	                  	say-yađ
t	                  		te
tahir	                  	ŧāher
tajinder	                ŧājenđar
tanmay	                  	ŧan-may
tare	                  	ŧārλ
tewatia	                  	ŧewāŧeya
thakur	                  	t-hākur
thampi	                  	ŧam-pe
tim	                  		tem
tiwary	                  	ŧewaree
tom	                  		töm
trent	                  	t-rλn-t
tripathi	                ŧ-repāt-hee
tye	                  		tāy
umesh	                  	umλs-h
unadkat	                  	unādkat
ur	                  		ur
uthappa	                  	uŧ-ŧap-pā
vijay	                  	wejay
villiers	                vel-leyarz
vinay	                  	wenay
virat	                  	werāt
vohra	                  	vorā
wankhade	                wankhadλ
warner	                  	wör-nar
washington	                wλs-heŋgtan
watson	                  	wöt-san
willey	                  	wel-lee
williamson	                wel-yamsan
woakes	                  	woak-s
wood	                  	wuud
wriddhiman	                w-ruđ-đ-hemān
xi	                  		elλvan
yadav	                  	yāđaw
yusuf	                  	yusuf
yuvraj	                  	yuwraj
yuzvendra	                yujwλn-đra
zahir	                  	zāheer
